11111111111111111111111111111111111111111111
10000000E001000C0100000000000000000000000001
10000000000000001101110000010000000000C10001
10000000000000001101110000010000000000C10001
11110000111001101C10101000011100000000000001
10000000000000001101110000010000000000C10001
1P000000000000001101110000010000000000C10001
11111111111111111111111111111111111111111111
