111111111111111111111
100001000000000000001
10E00C000000C000P0001
100000000000000000001
111111111111111111111
