11111111111111111111111111111111111111111111
10000000E001000C0100000000000000000000000001
10000000000000001101110000010000000000C10001
10000000000000001101110000010000000000C10001
111100P00111001101C1010100001110000000000001
10000000000000001101110000010000000000C10001
10000000000000001101110000010000000000C10001
11111111111111111111111111111111111111111111
