111111111111111111
10000000E001000C01
100000000000000011
111100P00111001101
111111111111111111
