1111111111111111111111111111111
1000000100010000000C00000000C01
1000001000R00000000000000000001
100000000C000000000C00100000001
100P00000000C00000000000R000001
10000000000000000000E0000000011
1111111111111111111111111111111