1111111111111111111111111111111
1000R00100010000000C00000000C01
100000100000R000000000000000001
100000000C000000000C00100000001
100P00000000C000000000000000001
1R000000000000000000E0000000011
1111111111111111111111111111111