1111111111111111111111111111111
1000000100R10000000C00000000C01
1000001000R00000000000000000001
100000R00C000000000C00100000001
100P0000000RC00000000000R000001
10000000000000000000E0000000011
1111111111111111111111111111111