1111111111111111111111111111111
1000000100010000000C00000000C01
1000001000000000000000000000001
100000000C000000000C00100000001
100P00000000C0000000000R0000001
10000R00000000000000E0000000011
1111111111111111111111111111111